###############
#     @ 0     #
#             #
#             #
#             #
#             #
#aaaaaaaaaaaa #
#             #
#             #
#             #
#g            #
#             #
#             #
#            n#
###############
