###############
# @           #
#             #
#  0          #
#             #
#             #
#             #
#             #
#h            #
#             #
#             #
#             #
#             #
#             #
###############
