###############
# @           #
#             #
#  0          #
#             #
#             #
#             #
#   aaaaaa    #
#h            #
#v            #
#             #
#             #
#             #
#             #
###############
