###############
#     @ 0     #
#             #
#             #
#             #
#             #
#             #
#             #
#hhgg         #
#             #
#             #
#             #
#             #
#             #
###############
