###############
#     @ 0     #
#             #
#             #
#             #
#             #
#             #
#             #
#             #
#             #
#g            #
#             #
#             #
#             #
###############
