###############
#     0@      #
#             #
#             #
# aaaaaaa     #
#g            #
#             #
#             #
#             #
#             #
#             #
#             #
#             #
#             #
###############
