###############
#     @ 0     #
#             #
#             #
#             #
#             #
#             #
#             #
#aaaaaaaaae   #
#             #
#r            #
#  b        hh#
#             #
#             #
###############
